R 800 1200
SO ./path_to_the_south_texture
NO ./path_to_the_north_texture
EA ./path
S ./path_to_the_sprite_texture
WE ./path_to_the_west_texture
F 220,100,0
C 225,30,0

1111111111111111111
1000100001000000001
1000000000000000001
100000S000000000111
1000000000000000001
1000001000010000001
1111111111111111111