NO srcs/cube_functions/textures/wall_2.xpm
SO srcs/cube_functions/textures/wall_1.xpm
WE srcs/cube_functions/textures/wall_4.xpm
EA srcs/cube_functions/textures/wall_3.xpm
S  srcs/cube_functions/textures/sprite_1.xpm
F 220,100,0
R 1000 1501
C 225,30,0


11111111111111111111111111111
11000000001100000000000000001
101100N0011100000000000010001
101100N0011100000000000010001
101100N0011100000000000010001
101100N0011100000000000010001
11111111111111111111111111111
