F 220,100,06
C 225,30,0
NO srcs/cube_functions/textures/wall_2.xpm
SO srcs/cube_functions/textures/wall_1.xpm
WE srcs/cube_functions/textures/wall_4.xpm
EA srcs/cube_functions/textures/wall_3.xpm
S srcs/cube_functions/textures/sprite_1.xpm
R 1 1

11111111111111
10000000000001
10000000000001
10000222222201
10000000000001
10000000000001
100000N0000001
10000000000001
10000000000001
10000000000001
10000000000001
11111111111111


