NO srcs/cube_functions/textures/wall_2.xpm
SO srcs/cube_functions/textures/wall_1.xpm
WE srcs/cube_functions/textures/wall_4.xpm
EA srcs/cube_functions/textures/wall_3.xpm
S  srcs/cube_functions/textures/sprite_1.xpm
F 220,100,0
R 1500 1501
C 225,30,0

11111111111111111111111111111
10000000001100000000000000001
10110000011100000000000010001
10100000000000000000000100001
10110000011100000000000010001
10000000001100000111011110001
11110111111111011100000010001
11110111111111011100000010001
11000000110101011101010010001
1000N000000000001100000100001
10000000000000001101010010001
11000000110101000000000000001
11111111111010000000000000001
10000000021100000100000010001
10022200000000001010000110001
10022200021000010001010001001
10000000001101000000000000001
10000000001000000010100000001
11111111111111111111111111111