R       800 4000
SO srcs/cube_functions/textures/barrel.png
S srcs/cube_functions/textures/sprite_1.xpm
NO srcs/cube_functions/textures/wall_2.xpm
F 254,0254,254
EA srcs/cube_functions/textures/wall_3.xpm




WE srcs/cube_functions/textures/wall_4.xpm
C 255,000,15

11111111111111 1111
11000000000001 1001
11000000000001 1N01
1100000000000111221
 1111111110011211111
 1111111111111111111
11100000000000000001
11000000000001111111
11111111111111