R       2147483648 8888888888012312312312
SO srcs/cube_functions/textures/barrel.png
S srcs/cube_functions/textures/sprite_1.xpm
NO srcs/cube_functions/textures/wall_2.xpm
F 254,0254,254
EA srcs/cube_functions/textures/wall_3.xpm




WE srcs/cube_functions/textures/wall_4.xpm
C 255,000,15

11111111111111 1111
11000000000001 1001
11000000000001 1001
11000000000001110011
 1111111110011210001
11100000000000000001
1100000N000001111111
11111111111111