F 0220,0100,06
C 0220,0100,06
NO srcs/cube_functions/textures/wall_2.xpm
SO srcs/cube_functions/textures/wall_1.xpm
WE srcs/cube_functions/textures/wall_4.xpm
EA srcs/cube_functions/textures/wall_3.xpm
S srcs/cube_functions/textures/sprite_1.xpm
R 3000 3000

    11111111111111
    10000000000001
    11110000000001
    10000222222201
111110000000011111    
10000000000001
100000N0000001
10000000000001
10000000000001
10000000000001
10000000000001
11111111111111


