R 1000 1000
SO srcs/cube_functions/textures/barrel.png
S srcs/cube_functions/textures/sprite_1.xpm
NO srcs/cube_functions/textures/wall_2.xpm
F 0220,0100,06
EA srcs/cube_functions/textures/wall_3.xpm
WE srcs/cube_functions/textures/wall_4.xpm
C 0225,030,0

1111111111111 1111
1000000000001 1001
1000000000001 1001
100000000000111001

111111111111111111
100N00000000000001
100000000000111111
1111111111111

