NO srcs/cube_functions/textures/wall_2.xpm
SO srcs/cube_functions/textures/wall_1.xpm
WE srcs/cube_functions/textures/wall_4.xpm
EA srcs/cube_functions/textures/wall_3.xpm
S  srcs/cube_functions/textures/sprite_1.xpm
F 220,100,0
R 1000 1501
C 225,30,0

11111111111111111111111111111
10000000001100000000000000001
10110000011100000000000010001
10100000000000000000000100001
10110000011100000000000010001
10000000001100000111011110001
11110111111111011100000010001
11110111111111011100000010001
1100000011010101110101001000111111111111111111
1000000000000000110000010000000001100000100001
1000000000000000110101001000000000000000000001
1100000011010100000000000000000001100000100001
1111011111101000000000000000111111111111111011
10000000001100000100000010001           100001
10000000000000001010000110001           100001
10000000001000010001010001001           111111
1000000000110100000N000000001
10000000001000000010100000001
11111111111111111111111111111